20.ox
.o...........o.o..o.
o..o..oo..oo........
......o.....o.o.....
....o.......oo.....o
o.ooooo.o...o...o...
...........o.oo...oo
......o......o......
o..o....o........ooo
.o..o.....o.o.o...o.
..........oo.o.ooo..
..o.o.....o.o.....o.
o.oo.o...........oo.
..o.o..o.ooo.oo.o...
oo.oo..oooo..o......
...........oo.......
...oo.o....oo...o.o.
..o..o.........o...o
...o.........oo.o...
o.....ooo.....oo..o.
....o...o.......o...
